11 9
61 61
1 5 5 5 5 5 5 5 5 5 2
8 0 0 0 0 0 0 0 0 0 7
8 0 0 0 0 0 0 0 0 0 7
8 0 0 0 0 0 0 0 0 0 7
8 0 0 0 0 0 0 0 0 0 7
8 0 0 0 0 0 0 0 0 0 7
8 0 0 0 0 0 0 0 0 0 7
8 0 0 0 0 0 0 0 0 0 7
3 6 6 6 6 6 6 6 6 6 4